###########################
#************#************#
#*####*#####*#*#####*####*#
#*####*#####*#*#####*####*#
#*####*#####*#*#####*####*#
#*************************#
#*####*#*#########*#*####*#
#*####*#*#########*#*####*#
#******#*****#*****#******#
######*#####*#*#####*######
######*#    ***    #*######
######*# ######### #*######
######*# ######### #*######
######*# #       # #*######
#     *# #       # #*     #
######*# #       # #*######
######*# ######### #*######
######*# ######### #*######
######*#           #*######
######*#*#########*#*######
#************#************#
#*####*#####*#*#####*####*#
#*####*#####*#*#####*####*#
#***##***************##***#
###*##*##*#######*##*##*###
#******##****#****##******#
#*##########*#*##########*#
#*##########*#*##########*#
#*************************#
###########################